0,1,3,5,7,1,7
1,1,1,4,4,4,5
1,1,5,4,3,7,3
3,4,4,4,6,5,6
4,3,7,6,6,5,6
6,3,1,4,4,6,2
