1 1 4 4 1 1 2
4 1 1 1 1 4 4
4 1 0 4 3 4 4
4 1 1 1 1 4 4
1 3 4 4 3 3 4
4 1 1 4 3 3 4