6,3,1,4,1,1,1
6,7,1,1,5,4,1
6,3,5,4,1,5,1
1,3,5,5,7,7,7
1,6,4,3,7,6,4
0,6,6,4,2,4,6