4,4,4,4,4,4,4
4,1,1,3,1,1,4
4,0,1,3,1,1,4
4,1,1,3,1,2,4
4,1,1,3,1,1,4
4,4,1,5,1,4,4