1 1 4 1 1 1 1
4 5 1 5 1 4 4
1 1 0 1 3 4 4
1 5 1 1 2 4 4
4 1 3 4 3 1 4
4 1 1 4 3 1 4