4,6,4,1,7,7,1
1,1,5,4,1,1,6
1,1,5,1,7,6,3
4,4,4,1,6,5,5
1,1,1,3,4,6,5
0,1,4,6,6,4,2