1,1,3,5,1,6,1
1,1,3,6,1,1,1
0,1,3,6,1,2,1
1,1,3,6,1,1,1
1,1,3,6,1,1,1
1,1,3,5,1,6,1