1,1,1,1,7,2,7
5,4,4,1,6,7,6
1,1,4,4,4,1,4
0,1,1,5,1,7,1
1,1,1,1,4,4,4
4,4,4,4,4,1,1