4,4,1,1,1,1,1
2,4,1,1,1,1,1
4,4,1,1,1,1,1
6,6,1,1,1,1,1
0,6,1,1,1,1,1
6,6,1,1,1,1,1