1 1 4 1 5 1 1
4 5 1 5 1 4 4
1 1 0 4 3 4 4
1 6 1 1 2 6 6
1 3 7 4 3 1 4
4 1 1 4 3 1 4