1,1,1,1,6,5,2
1,1,1,1,5,1,5
1,1,1,1,6,5,6
1,1,1,1,1,1,1
7,7,7,1,1,1,1
0,5,7,1,1,1,1