1,1,1,4,6,4,2
1,1,1,7,1,1,4
1,1,1,5,7,7,4
1,1,1,1,7,1,6
7,7,7,1,1,1,1
0,5,7,1,1,1,1