1 8 4 1 5 1 1
4 5 1 5 8 4 4
8 5 0 4 3 4 4
5 6 1 1 2 6 6
8 3 1 4 3 1 4
4 1 1 4 3 1 4