4,6,4,4,6,4,4
4,6,3,7,5,2,4
4,1,3,3,7,4,4
4,5,6,3,3,7,4
1,1,5,1,6,3,4
0,1,4,4,6,4,6