0,1,1,1,1,1,1
1,5,7,6,6,5,6
1,1,6,5,7,3,7
1,1,5,7,3,7,3
1,1,6,3,7,3,2
1,1,3,7,3,7,3